######## ####B####
### #### ##     ##
### ####     #####
#      # #########
#### ###     #####
####   #####   ###
#                #
A ################
